P 0 4 4
G 4 4 2
B 1 4 4
B 3 4 4
B 3 4 7
W 0 3 4 0 0 0 0 0 0
W 1 3 4 0 0 0 0 0 0
W 2 2 4 0 0 0 0 0 0
W 2 4 6 0 0 0 0 0 1
W 2 3 7 0 0 0 0 0 0
W 2 7 4 0 0 0 0 0 0
W 2 7 5 0 0 0 0 0 0
W 2 7 6 0 0 0 0 0 0
W 2 7 7 0 0 0 0 0 0
W 3 3 4 0 0 0 0 0 0
W 3 3 7 0 0 0 0 0 0
W 3 4 6 0 0 0 0 0 0
W 3 7 4 0 0 0 0 0 0
W 4 2 4 0 0 0 0 0 0
W 4 4 1 0 0 0 0 0 0
W 4 7 4 0 0 0 0 0 0