P 4 2 0
G 8 4 3
B 5 4 4
W 4 1 0 0 0 0 0 0 0
W 5 1 0 0 0 0 0 0 0
W 5 2 0 1 0 0 0 0 0
W 0 2 0 0 0 0 0 0 0
W 0 1 0 0 0 0 0 0 0
W 0 0 0 0 0 0 0 0 0
W 9 0 0 0 0 0 0 0 0
W 9 1 0 0 0 0 0 0 0
W 9 2 0 0 0 0 0 0 0
W 6 2 0 0 0 0 1 0 0
W 6 2 1 0 0 0 0 0 0
W 6 2 2 0 0 0 0 0 0
W 6 4 2 1 0 0 0 0 0
W 6 4 3 0 0 0 0 0 0
W 7 4 4 0 0 0 0 0 0
W 9 4 5 0 0 0 0 0 0
W 9 4 4 0 0 0 0 0 0
W 9 4 3 0 0 0 0 0 0
W 1 4 5 1 1 0 0 1 1
W 7 4 6 1 1 0 0 1 1
W 5 3 4 0 0 0 0 0 0