P 1 2 0
G 8 4 3
B 2 4 0
B 5 4 0
B 5 9 0
B 8 4 0
W 1 1 0 0 0 0 0 0 0
W 2 1 0 0 0 0 0 0 0
W 3 0 0 0 0 0 0 0 0
W 1 3 0 1 0 0 1 0 0
W 2 3 0 0 0 0 0 0 0
W 4 1 0 0 0 0 0 0 0
W 5 1 0 0 0 0 0 0 0
W 6 0 0 0 0 0 0 0 0
W 4 3 0 1 0 0 1 0 0
W 5 3 0 0 0 0 0 0 0
W 7 1 0 0 0 0 0 0 0
W 8 1 0 0 0 0 0 0 0
W 9 0 0 0 0 0 0 0 0
W 7 3 0 1 0 0 1 0 0
W 8 3 0 0 0 0 0 0 0