P 4 4 4
G 4 2 4
B 6 4 4
W 4 3 3 0 0 0 0 0 0
W 4 1 4 0 0 0 0 0 0
W 4 3 4 1 1 1 1 0 0
W 4 6 4 0 0 0 0 0 0
W 4 3 5 0 0 0 0 0 0
W 5 3 3 0 0 0 0 0 0
W 5 1 4 0 0 0 0 0 0
W 5 6 4 0 0 0 0 0 0
W 5 1 5 0 0 0 0 0 0
W 5 3 5 0 0 0 0 0 0
W 5 6 5 0 0 0 0 0 0
W 6 3 3 0 0 0 0 0 0
W 6 1 4 0 0 0 0 0 0
W 6 3 4 0 0 0 0 0 0
W 6 6 4 0 0 0 0 0 0
W 6 1 5 0 0 0 0 0 0
W 6 3 5 0 0 0 0 0 0
W 6 6 5 0 0 0 0 0 0
W 6 3 6 0 0 0 0 0 0
W 7 3 4 0 0 0 0 0 0
W 7 1 4 0 0 0 0 0 0
W 7 6 4 0 0 0 0 0 0
W 7 1 5 0 0 0 0 0 0
W 7 6 5 0 0 0 0 0 0
W 7 3 6 0 0 0 0 0 0
W 8 3 4 0 0 0 0 0 0
W 8 1 5 0 0 0 0 0 0
W 8 3 5 1 1 1 1 0 0
W 8 6 5 0 0 0 0 0 0
W 8 3 6 0 0 0 0 0 0