P 1 2 1
G 5 3 4
B 5 5 5
W 1 1 1 1 1 1 1 1 1
W 1 1 8 1 1 1 1 1 1
W 1 8 1 1 1 1 1 1 1
W 1 8 8 1 1 1 1 1 1
W 3 4 8 1 1 1 1 1 1
W 3 4 5 1 1 1 1 1 1
W 3 8 8 1 1 1 1 1 1
W 5 2 4 1 1 1 1 1 1
W 5 4 5 1 1 1 1 1 1
W 5 4 6 1 1 1 1 1 1
W 6 1 1 1 1 1 1 1 1
W 6 2 4 1 1 1 1 1 1
W 6 8 1 1 1 1 1 1 1
W 8 1 1 1 1 1 1 1 1
W 8 1 4 1 1 1 1 1 1
W 8 1 8 1 1 1 1 1 1
W 8 5 8 1 1 1 1 1 1
W 8 8 1 1 1 1 1 1 1
W 8 8 8 1 1 1 1 1 1