P 0 4 0
G 9 3 9
L 2 3 0
W 0 3 0 0 0 0 0 0 0
W 1 3 0 0 0 0 0 0 0
B 1 4 0
W 2 2 0 0 0 0 0 0 0
W 3 3 0 0 0 0 0 0 0
B 3 4 0
W 4 2 0 0 0 0 0 0 0
W 5 3 0 0 0 0 0 0 0
B 5 4 0
W 6 2 0 0 0 0 0 0 0
W 7 3 0 0 0 0 0 0 0
B 7 4 0
W 8 2 0 0 0 0 0 0 0
G 8 3 0
