W 5 5 5 0 0 0 0 0 0
W 5 5 4 0 0 0 0 0 0
W 5 5 3 0 0 0 0 0 0
W 5 5 2 0 0 0 0 0 0
W 5 5 1 0 0 0 0 0 0
B 5 6 2 0 -1 0
G 5 6 5
P 5 6 1