W 5 5 5 0 0 0 0 0 0
W 5 5 4 0 0 0 0 0 0
W 5 5 3 0 0 0 0 0 0
W 5 5 2 0 0 0 0 0 0
W 5 5 1 0 0 0 0 0 0
W 6 5 5 0 0 0 0 0 0
W 6 5 4 0 0 0 0 0 0
W 6 5 3 0 0 0 0 0 0
W 6 5 2 0 0 0 0 0 0
W 6 5 1 0 0 0 0 0 0
W 7 5 4 0 0 0 0 0 0
W 7 5 3 0 0 0 0 0 0
W 7 5 2 0 0 0 0 0 0
B 6 6 3 0 -1 0
G 5 6 3
P 5 6 1