W 5 5 5 0 0 0 0 0 0
W 5 5 4 0 0 0 0 0 0
W 5 5 3 0 0 0 0 0 0
W 5 5 2 0 0 0 0 0 0
W 5 2 5 0 0 0 0 0 0
W 5 2 4 0 0 0 0 0 0
W 5 2 3 0 0 0 0 0 0
W 5 2 2 0 0 0 0 0 0
B 5 4 3 0 1 0
P 5 3 2
G 5 3 5